123movies => 123movies | 123movies Downloader (123movies-downloader.json)
123RF => 123RF | 123rf Downloader (123rf-downloader.json)
Adobe => Adobe | Adobe Stock Downloader (adobe-stock-downloader.json)
Alamy => Alamy | Alamy Downloader (alamy-downloader.json)
Amazon => Amazon | Amazon Video Downloader (amazon-video-downloader.json)
Beeg => Beeg | Beeg Video Downloader (beeg-video-downloader.json)
Bilibili => Bilibili | Bilibili Downloader (bilibili-downloader.json)
BongaCams => BongaCams | Bongacams Downloader (bongacams-downloader.json)
CamSoda => CamSoda | Camsoda Downloader (camsoda-downloader.json)
Canva => Canva | Canva Downloader (canva-downloader.json)
Chaturbate => Chaturbate | Chaturbate Downloader (chaturbate-downloader.json)
Circle => Circle | Circle Downloader (circle-downloader.json)
Coursera => Coursera | Coursera Downloader (coursera-downloader.json)
Dailymotion => Dailymotion | Dailymotion Downloader (dailymotion-downloader.json)
Depositphotos => Depositphotos | Depositphotos Downloader (depositphotos-downloader.json)
DeviantArt => DeviantArt | Deviantart Downloader (deviantart-downloader.json)
Dreamstime => Dreamstime | Dreamstime Downloader (dreamstime-downloader.json)
Eporner => Eporner | Eporner Video Downloader (eporner-video-downloader.json)
Erome => Erome | Erome Downloader (erome-downloader.json)
Facebook => Facebook | Facebook Video Downloader (facebook-video-downloader.json)
Flickr => Flickr | Flickr Downloader (flickr-downloader.json)
Freepik => Freepik | Freepik Downloader (freepik-downloader.json)
Getty Images => Getty Images | Getty Images Downloader (getty-images-downloader.json)
Giphy => Giphy | Giphy Downloader (giphy-downloader.json)
GoHighLevel => GoHighLevel | Gohighlevel Downloader (gohighlevel-downloader.json)
Gokollab => Gokollab | Gokollab Downloader (gokollab-downloader.json)
Hulu => Hulu | Hulu Downloader (hulu-downloader.json)
Instagram => Instagram | Instagram Downloader (instagram-downloader.json)
Internet Archive => Internet Archive | Internet Archive Downloader (internet-archive-downloader.json)
iStock => iStock | Istock Downloader (istock-downloader.json)
iStock => iStock | iStockphoto Downloader (istockphoto-downloader.json)
Kajabi => Kajabi | Kajabi Video Downloader (kajabi-video-downloader.json)
Khan Academy => Khan Academy | Khan Academy Downloader (khan-academy-downloader.json)
Kick => Kick | Kick Clip Downloader (kick-clip-downloader.json)
LearnDash => LearnDash | Learndash Downloader (learndash-downloader.json)
LearnWorlds => LearnWorlds | Learnworlds Downloader (learnworlds-downloader.json)
LinkedIn => LinkedIn | Linkedin Learning Downloader (linkedin-learning-downloader.json)
LiveJasmin => LiveJasmin | Livejasmin Downloader (livejasmin-downloader.json)
Loom => Loom | Loom Video Downloader (loom-video-downloader.json)
Moodle => Moodle | Moodle Downloader (moodle-downloader.json)
MyFreeCams => MyFreeCams | Myfreecams Downloader (myfreecams-downloader.json)
Netflix => Netflix | Netflix Downloader (netflix-downloader.json)
OnlyFans => Fenix International Limited | Onlyfans Downloader (onlyfans-downloader.json)
Patreon => Patreon | Patreon Downloader (patreon-downloader.json)
Pexels => Pexels | Pexels Video Downloader (pexels-video-downloader.json)
Pinterest => Pinterest | Pinterest Downloader (pinterest-downloader.json)
Pixabay => Pixabay | Pixabay Downloader (pixabay-downloader.json)
Podia => Podia | Podia Downloader (podia-downloader.json)
Pornhub => Pornhub | Pornhub Video Downloader (pornhub-video-downloader.json)
Rawpixel => Rawpixel | Rawpixel Downloader (rawpixel-downloader.json)
Reddit => Reddit | Reddit Downloader (reddit-downloader.json)
Redgifs => Redgifs | Redgifs Downloader (redgifs-downloader.json)
Redtube => Redtube | Redtube Video Downloader (redtube-video-downloader.json)
Scribd => Scribd | Scribd Downloader (scribd-downloader.json)
Shutterstock => Shutterstock | Shutterstock Downloader (shutterstock-downloader.json)
Skillshare => Skillshare | Skillshare Downloader (skillshare-downloader.json)
Skool => Skool | Skool Video Downloader (skool-video-downloader.json)
Snapchat => Snapchat | Snapchat Video Downloader (snapchat-video-downloader.json)
SoundCloud => SoundCloud | Soundcloud Downloader (soundcloud-downloader.json)
SpankBang => SpankBang | SpankBang Video Downloader (spankbang-video-downloader.json)
Sprout => Sprout | Sprout Video Downloader (sprout-video-downloader.json)
Stocksy => Stocksy | Stocksy Downloader (stocksy-downloader.json)
Stockvault => Stockvault | Stockvault Downloader (stockvault-downloader.json)
Storyblocks => Storyblocks | Storyblocks Downloader (storyblocks-downloader.json)
Stripchat => Stripchat | Stripchat Video Downloader (stripchat-video-downloader.json)
Teachable => Teachable | Teachable Video Downloader (teachable-video-downloader.json)
Telegram => Telegram | Telegram Video Downloader (telegram-video-downloader.json)
Terabox => Terabox | Terabox Downloader (terabox-downloader.json)
Thinkific => Thinkific | Thinkific Downloader (thinkific-downloader.json)
TikTok => TikTok | Tiktok Downloader (tiktok-downloader.json)
TNAFlix => TNAFlix | TNAFlix Video Downloader (tnaflix-video-downloader.json)
Tubi => Tubi | Tubi Downloader (tubi-downloader.json)
Tumblr => Tumblr | Tumblr Video Downloader (tumblr-video-downloader.json)
Twitch => Twitch | Twitch Video Downloader (twitch-video-downloader.json)
Twitter => Twitter | Twitter Video Downloader (twitter-video-downloader.json)
Udemy => Udemy | Udemy Video Downloader (udemy-video-downloader.json)
Unsplash => Unsplash | Unsplash Downloader (unsplash-downloader.json)
VectorStock => VectorStock | Vectorstock Downloader (vectorstock-downloader.json)
Vimeo => Vimeo | Vimeo Video Downloader (vimeo-video-downloader.json)
VK => VK | Vk Video Downloader (vk-video-downloader.json)
Whop => Whop | Whop Video Downloader (whop-video-downloader.json)
Wistia => Wistia | Wistia Video Downloader (wistia-video-downloader.json)
XHamster => XHamster | Xhamster Video Downloader (xhamster-video-downloader.json)
XNXX => XNXX | XNXX Video Downloader (xnxx-video-downloader.json)
XVideos => XVideos | XVideos Downloader (xvideos-downloader.json)
YouPorn => YouPorn | Youporn Video Downloader (youporn-video-downloader.json)
YouTube => YouTube | Youtube Downloader (youtube-downloader.json)
