Trademarked brand usage (generated 2025-11-11T15:08:16.338Z)
============================================================

123movies => 123movies Downloader (123movies-downloader.json)
123RF => 123rf Downloader (123rf-downloader.json)
Adobe => Adobe Stock Downloader (adobe-stock-downloader.json)
Alamy => Alamy Downloader (alamy-downloader.json)
Amazon => Amazon Video Downloader (amazon-video-downloader.json)
Beeg => Beeg Video Downloader (beeg-video-downloader.json)
Bilibili => Bilibili Downloader (bilibili-downloader.json)
BongaCams => Bongacams Downloader (bongacams-downloader.json)
CamSoda => Camsoda Downloader (camsoda-downloader.json)
Canva => Canva Downloader (canva-downloader.json)
Chaturbate => Chaturbate Downloader (chaturbate-downloader.json)
Circle => Circle Downloader (circle-downloader.json)
Coursera => Coursera Downloader (coursera-downloader.json)
Dailymotion => Dailymotion Downloader (dailymotion-downloader.json)
Depositphotos => Depositphotos Downloader (depositphotos-downloader.json)
DeviantArt => Deviantart Downloader (deviantart-downloader.json)
Dreamstime => Dreamstime Downloader (dreamstime-downloader.json)
Eporner => Eporner Video Downloader (eporner-video-downloader.json)
Erome => Erome Downloader (erome-downloader.json)
Facebook => Facebook Video Downloader (facebook-video-downloader.json)
Flickr => Flickr Downloader (flickr-downloader.json)
Freepik => Freepik Downloader (freepik-downloader.json)
Getty Images => Getty Images Downloader (getty-images-downloader.json)
Giphy => Giphy Downloader (giphy-downloader.json)
GoHighLevel => Gohighlevel Downloader (gohighlevel-downloader.json)
Gokollab => Gokollab Downloader (gokollab-downloader.json)
Hulu => Hulu Downloader (hulu-downloader.json)
Instagram => Instagram Downloader (instagram-downloader.json)
Internet Archive => Internet Archive Downloader (internet-archive-downloader.json)
iStock => Istock Downloader (istock-downloader.json)
iStock => iStockphoto Downloader (istockphoto-downloader.json)
Kajabi => Kajabi Video Downloader (kajabi-video-downloader.json)
Khan Academy => Khan Academy Downloader (khan-academy-downloader.json)
Kick => Kick Clip Downloader (kick-clip-downloader.json)
LearnDash => Learndash Downloader (learndash-downloader.json)
LearnWorlds => Learnworlds Downloader (learnworlds-downloader.json)
LinkedIn => Linkedin Learning Downloader (linkedin-learning-downloader.json)
LiveJasmin => Livejasmin Downloader (livejasmin-downloader.json)
Loom => Loom Video Downloader (loom-video-downloader.json)
Moodle => Moodle Downloader (moodle-downloader.json)
MyFreeCams => Myfreecams Downloader (myfreecams-downloader.json)
Netflix => Netflix Downloader (netflix-downloader.json)
OnlyFans => Onlyfans Downloader (onlyfans-downloader.json)
Patreon => Patreon Downloader (patreon-downloader.json)
Pexels => Pexels Video Downloader (pexels-video-downloader.json)
Pinterest => Pinterest Downloader (pinterest-downloader.json)
Pixabay => Pixabay Downloader (pixabay-downloader.json)
Podia => Podia Downloader (podia-downloader.json)
Pornhub => Pornhub Video Downloader (pornhub-video-downloader.json)
Rawpixel => Rawpixel Downloader (rawpixel-downloader.json)
Reddit => Reddit Downloader (reddit-downloader.json)
Redgifs => Redgifs Downloader (redgifs-downloader.json)
Redtube => Redtube Video Downloader (redtube-video-downloader.json)
Scribd => Scribd Downloader (scribd-downloader.json)
Shutterstock => Shutterstock Downloader (shutterstock-downloader.json)
Skillshare => Skillshare Downloader (skillshare-downloader.json)
Skool => Skool Video Downloader (skool-video-downloader.json)
Snapchat => Snapchat Video Downloader (snapchat-video-downloader.json)
SoundCloud => Soundcloud Downloader (soundcloud-downloader.json)
SpankBang => SpankBang Video Downloader (spankbang-video-downloader.json)
Sprout => Sprout Video Downloader (sprout-video-downloader.json)
Stocksy => Stocksy Downloader (stocksy-downloader.json)
Stockvault => Stockvault Downloader (stockvault-downloader.json)
Storyblocks => Storyblocks Downloader (storyblocks-downloader.json)
Stripchat => Stripchat Video Downloader (stripchat-video-downloader.json)
Teachable => Teachable Video Downloader (teachable-video-downloader.json)
Telegram => Telegram Video Downloader (telegram-video-downloader.json)
Terabox => Terabox Downloader (terabox-downloader.json)
Thinkific => Thinkific Downloader (thinkific-downloader.json)
TikTok => Tiktok Downloader (tiktok-downloader.json)
TNAFlix => TNAFlix Video Downloader (tnaflix-video-downloader.json)
Tubi => Tubi Downloader (tubi-downloader.json)
Tumblr => Tumblr Video Downloader (tumblr-video-downloader.json)
Twitch => Twitch Video Downloader (twitch-video-downloader.json)
Twitter => Twitter Video Downloader (twitter-video-downloader.json)
Udemy => Udemy Video Downloader (udemy-video-downloader.json)
Unsplash => Unsplash Downloader (unsplash-downloader.json)
VectorStock => Vectorstock Downloader (vectorstock-downloader.json)
Vimeo => Vimeo Video Downloader (vimeo-video-downloader.json)
VK => Vk Video Downloader (vk-video-downloader.json)
Whop => Whop Video Downloader (whop-video-downloader.json)
Wistia => Wistia Video Downloader (wistia-video-downloader.json)
XHamster => Xhamster Video Downloader (xhamster-video-downloader.json)
XNXX => XNXX Video Downloader (xnxx-video-downloader.json)
XVideos => XVideos Downloader (xvideos-downloader.json)
YouPorn => Youporn Video Downloader (youporn-video-downloader.json)
YouTube => Youtube Downloader (youtube-downloader.json)
